11111111111111111111111
1XC0C0C000010000C000CX1
10111011110101111011101
10111011110101111011101
10000000000P00000000001
10111010111111101011101
10C0001C000E00001000C01
11111X10111111101X11111
1C000000000C0000000C001
10111011110101111011101
11111111111111111111111